border_size=1
usage=map

Gs^Fdw      , Gs^Fdw      , Gs^Fdw      , Gg          , Gs^Fdw      , Gs^Fdw      , Aa          , Ai          , Ai          , Ai          , Ai          , Aa          , Aa          , Gs^Fp       , Gs^Fp       , Gs^Fp       , Gs^Fp       , Gs^Fp       , Hhd^Fmw     , Hhd^Fmw     , Hhd^Fmw     , Hhd^Fmw     , Hhd^Fmw     , Mm          , Mm          , Mm          , Mm          , Mm          , Ms          , Ms          , Ms          , Gg          , Gg          , Gg          , Gg          , Gg          , Gg          , Gg          , Gg          , Gg          , Gg          , Gg          , Gg          , Gg          , Gg          , Gg          , Gg          , Gg          , Gg          , Gg          , Gg          , Gg          
Gs^Fdw      , Gs^Fdw      , Gs^Fdw      , Gs^Fdw      , Gs^Fdw      , Gs^Fdw      , Aa          , Aa          , Aa          , Ai          , Ai          , Ai          , Ai          , Aa          , Aa          , Gs^Fp       , Aa          , Gs^Fp       , Aa          , Hhd^Fmw     , Hhd^Fmw     , Hhd^Fmw     , Hhd^Fmw     , Hhd^Fmw     , Hhd^Fmw     , Hhd^Vhhr    , Aa          , Ms          , Ms          , Ms          , Aa          , Gg          , Gg          , Gg          , Aa          , Gg          , Ce          , Ce          , Ce          , Gg          , Gg          , Gg^Efm      , Gg          , Gg          , Ce          , Ce          , Ce          , Gg          , Gg          , Gg          , Gg          , Gg          
Gs^Fdw      , Gs^Fdw      , Gs^Fdw      , Gs^Fdw      , Aa^Fda      , Gs^Fdw      , Aa          , Aa          , Aa          , Aa^Fda      , Aa          , Ai          , Ai          , Ai          , Ai          , Aa          , Aa          , Aa^Fda      , Aa          , Aa          , Ha^Fda      , Ha^Fpa      , Ha          , Hhd^Fmw     , Gg          , Gg          , Gg          , Aa          , Gg          , Aa^Vha      , Aa          , Aa          , Aa          , Gg          , Gg          , Gg          , Cea         , 4 Kea       , Ce          , Gg          , Gg          , Gg          , Gg          , Gg          , Ce          , Aa^Dr       , Ce          , Gg          , Gg          , Gg          , Gg          , Gg          
Gs^Fdw      , Gs^Fdw      , Gg          , Gg          , Gg          , Aa^Fda      , Aa          , Aa          , Aa          , Aa          , Aa          , Aa          , Aa          , Ai          , Ai          , Ai          , Ai          , Aa          , Aa          , Ha^Fma      , Ai          , Ai          , Ai          , Ha          , Ha          , Gg          , Ce          , Gg          , Gg          , Aa          , Aa^Fda      , Aa          , Aa          , Aa          , Re          , Aa          , Re          , Ce          , Gg          , Gg          , Gg          , Aa          , Gg          , Gg          , Re          , Cea         , Re          , Gg          , Gg          , Gg^Efm      , Chr         , Gg          
Gg          , Gg          , Gg          , Gg          , Aa          , Aa          , Aa          , Aa          , Aa          , Aa          , Aa          , Aa          , Aa          , Aa          , Aa^Fda      , Ai          , Ai          , Ai          , Ai          , Ai          , Wwr         , Wwr         , Wwr         , Ai^Bw/      , Ha          , Cea         , 2 Kea       , Ce          , Gs          , Aa          , Aa          , Aa          , Aa          , Aa          , Re          , Re^Efm      , Re          , Re          , Aa          , Gg          , Gg          , Gg          , Aa          , Re          , Aa          , Aa          , Aa          , Gg          , Chr         , Chr         , Chr^Dr      , Chr         
Gg          , Gg^Efm      , Gg          , Gg          , Gg          , Aa          , Aa          , Aa          , Aa          , Aa^Es       , Aa          , Aa          , Aa          , Aa          , Aa          , Aa          , Aa          , Ai          , Ai          , Ai          , Wwr         , Wwf^Es      , Ai          , Ai          , Aa          , Cea         , Ce          , Cea         , Aa          , Aa          , Aa^Fda      , Aa          , Aa          , Aa          , Aa          , Aa          , Aa          , Aa          , Aa          , Aa^Vha      , Aa          , Aa          , Aa          , Aa^Fda      , Aa          , Aa          , Aa          , Aa          , Gs          , Gs          , 6 Khr       , Chr         
Gg          , Gg          , Gg          , Gg          , Gg          , Gg          , Aa          , Aa          , Aa          , Aa          , Aa          , Aa          , Aa          , Aa          , Aa          , Aa          , Aa          , Aa          , Aa          , Ai          , Ai          , Ai          , Ai          , Ai          , Aa          , Re          , Re          , Re          , Aa          , Aa          , Aa^Fda      , Aa          , Aa          , Aa          , Aa^Fda      , Aa          , Aa          , Aa          , Aa          , Aa          , Aa          , Aa          , Aa          , Aa          , Aa          , Aa          , Aa          , Aa          , Chr^Dr      , Gs          , Chr         , Chr         
Gg          , Gg          , Gg^Efm      , Gg          , Aa          , Aa          , Aa          , Aa          , Aa          , Aa          , Aa          , Aa          , Aa          , Aa          , Aa          , Aa          , Gs          , Aa          , Gs          , Aa          , Aa          , Ai          , Aa          , Aa          , Gs          , Aa          , Aa          , Aa          , Aa          , Aa^Fda      , Aa^Fda      , Aa          , Aa          , Aa          , Aa          , Aa          , Aa          , Aa^Es       , Aa          , Aa          , Aa^Fda      , Aa          , Aa          , Aa          , Aa          , Aa^Fda      , Aa          , Aa          , Aa          , Chr         , Chr         , Chr^Dr      
Gg          , Gg          , Gg          , Gg          , Aa          , Aa          , Aa          , Aa          , Aa          , Aa          , Aa          , Aa          , Aa          , Aa          , Aa          , Aa          , Aa          , Gs          , Aa          , Aa          , Gg          , Aa          , Gs          , Gs          , Gg          , Aa          , Re^Em       , Aa          , Aa          , Aa          , Aa          , Aa          , Gs          , Aa          , Aa          , Aa          , Aa          , Aa          , Aa          , Aa          , Aa          , Aa          , Aa          , Aa          , Gs^Es       , Aa          , Gs          , Aa          , Aa          , Aa          , Ggf         , Gg          
Gg          , Gg          , Gg          , Gg          , Aa          , Aa          , Aa          , Aa^Fda      , Aa^Fpa      , Aa          , Aa          , Aa          , Aa          , Aa^Es       , Aa          , Aa          , Aa          , Aa          , Gg          , Gg          , Gs          , Gg^Em       , Gg          , Aa          , Gg          , Re          , Re          , Aa          , Aa          , Aa          , Aa          , Aa          , Gs          , Gs          , Aa          , Aa          , Gs          , Aa          , Aa          , Aa          , Aa          , Aa          , Re          , Re          , Ce          , Cea         , Cea         , Aa          , Aa          , Aa          , Aa          , Gg          
Gg          , Gg^Efm      , Gg          , Gg          , Gg          , Aa          , Aa          , Aa^Fma      , Aa          , Aa          , Aa          , Aa          , Aa          , Aa          , Aa          , Aa          , Aa          , Aa          , Aa          , Gg          , Gs^Efm      , Gg          , Gg^Em       , Gg          , Gg          , Re          , Aa          , Aa          , Aa          , Aa^Es       , Aa          , Aa          , Gs          , Aa          , Aa          , Gs          , Gs          , Aa          , Aa          , Aa          , Aa          , Aa          , Aa          , Re          , Cea         , 5 Kea       , Cea         , Gs          , Aa          , Aa          , Aa^Vha      , Aa          
Gg          , Gg          , Gg          , Gg          , Gg          , Gg          , Rd          , Rd          , Aa          , Aa          , Aa          , Aa          , Aa          , Aa          , Aa          , Aa^Fda      , Aa^Fda      , Aa          , Aa          , Gg          , Aa          , Aa          , Aa          , Gg          , Aa          , Aa          , Aa          , Aa^Fda      , Aa          , Aa          , Re          , Gs^Em       , Aa          , Aa          , Gg          , Aa          , Aa          , Gs          , Aa          , Aa^Fda      , Aa          , Aa          , Aa          , Gs          , Aa          , Cea         , Aa          , Gs          , Aa^Fda      , Aa          , Aa          , Aa          
Gg          , Gg          , Gg          , Cea         , Aa          , Rd          , Aa          , Aa          , Aa          , Aa          , Aa          , Aa          , Aa          , Aa          , Aa          , Aa^Fda      , Aa          , Aa          , Aa          , Aa          , Aa          , Aa          , Aa          , Aa          , Aa          , Aa^Fda      , Aa^Fda      , Aa^Fda      , Aa          , Re          , Re          , Re          , Re          , Aa          , Re          , Re          , Aa          , Aa          , Aa          , Aa          , Aa          , Aa          , Gs          , Aa          , Re          , Re          , Re          , Aa          , Aa          , Aa          , Aa          , Aa          
Gg          , Gg          , Rd          , Aa          , Aa          , Aa          , Aa          , Aa          , Aa          , Aa^Vha      , Gs          , Aa          , Aa          , Aa          , Gs          , Aa          , Aa          , Aa          , Aa          , Aa          , Aa          , Aa          , Aa          , Aa          , Aa          , Aa^Fda      , Aa          , Aa          , Aa          , Gg          , Gg^Efm      , Re          , Ce          , Cea         , Ce          , Re          , Aa          , Aa          , Aa          , Aa          , Aa          , Aa          , Aa          , Gs          , Aa          , Re          , Re          , Re          , Cea         , Aa          , Aa          , Aa          
Rd          , Rd          , Rd          , 1 Aa        , Rd          , Aa          , Aa          , Aa          , Aa          , Aa          , Aa          , Gs          , Gg          , Gs          , Gs          , Aa          , Aa          , Aa          , Aa          , Aa          , Aa          , Aa          , Aa          , Aa          , Aa          , Aa          , Aa          , Aa          , Gg          , Gg          , Gs          , Gg          , Ce          , 3 Kea       , Ce          , Gg          , Aa          , Aa          , Aa          , Aa^Fda      , Aa          , Gs          , Gs          , Aa          , Gg          , Gg          , Gg          , Ce          , Aa^Dr       , Cea         , Gg          , Gg          
Rd          , Rd          , Rd          , Rd          , Gs          , Cea         , Aa          , Aa          , Aa          , Aa          , Gg          , Gg          , Gg          , Gg^Efm      , Gg          , Gg          , Gg          , Aa          , Gg          , Gg          , Gg          , Aa^Vea      , Gg          , Gg          , Gg          , Aa          , Gg^Es       , Gg          , Gg          , Gg^Efm      , Gg          , Gg          , Gg          , Ce          , Gg          , Gg          , Gg          , Aa          , Aa^Vha      , Aa          , Gg          , Aa          , Aa          , Gg          , Gg          , Gs^Efm      , Gg          , Ce          , Ce          , Ce          , Gg          , Gg          
Rd          , Rd          , Gg          , Gs          , Gg          , Aa          , Gg          , Aa          , Gg          , Gg          , Gg          , Gg          , Gg          , Gg          , Gg          , Gg          , Gg          , Gg          , Gg          , Gg          , Gg          , Gg          , Gg          , Gg          , Gg          , Gg          , Gg          , Gg          , Gg          , Gg          , Gg          , Gg          , Gg          , Gg          , Gg          , Gg          , Gg          , Gg          , Gg          , Gg          , Gg          , Gg          , Gg          , Gg          , Gg          , Gg          , Gg          , Gg          , Gg          , Gg          , Gg          , Gg          
