border_size=1
usage=map

Aa          , Aa          , Aa          , Aa          , Rb          , Aa          , Aa          , Aa          , Aa          , Aa          , Aa          , Aa          , Aa          , Aa          , Aa          , Aa          , Aa          , Aa          , Aa          , Aa          , Aa^Fda      , Aa          , Aa          , Aa          , Aa          , Aa          , Aa          
Aa          , Aa          , Ai          , Ai          , Ai          , Rb          , Rb          , Aa          , Aa          , Aa          , Ai          , Ai          , Aa          , Aa          , Aa          , Aa          , Aa          , Aa          , Aa          , Aa          , Aa          , Aa          , Aa          , Aa          , Aa          , Aa          , Aa          
Ai          , Ai          , Wwr         , Wwr         , Wwr         , Ai          , Rb          , Rb          , Rb          , Aa          , Aa          , Ai          , Aa          , Aa          , Cea         , Aa          , Ai          , Aa          , Ai          , Aa          , Aa          , Aa          , Aa          , Aa          , Rb          , Rb          , Rb          
Wwf         , Wwr         , Ai          , Ai          , Rb          , Ww^Bw/      , Wwr         , Aa          , Aa          , Rb          , Rb          , Aa          , Cea         , Cea         , Re^Vi       , Cea         , Cea         , Ai          , Aa          , Aa          , Aa          , Aa          , Rb          , Rb          , Aa          , Aa          , Aa          
Ai          , Ai          , Rb          , Rb          , Aa          , Ai          , Ai          , Ai          , Wwr         , Aa          , Cea         , Cea         , Re^Vi       , Re^Vi       , Re^Vi       , Re^Vi       , Re^Vi       , Cea         , Cea         , Aa          , Rb          , Rb          , Aa          , Aa          , Aa          , Aa          , Aa          
Aa          , Aa          , Rb          , Rb          , Rb          , Aa          , Aa          , Aa          , Aa          , Wwr         , Cea         , Cea         , Cea         , Re^Vi       , Re^Vi       , Re^Vi       , Cea         , Ce          , Cea         , Rb          , Aa          , Aa          , Aa          , Aa          , Aa          , Aa          , Aa          
Rb          , Rb          , Aa          , Aa          , Aa          , Rb          , Rb          , Gs^Fdw      , Aa          , Wwr         , Cea         , Re^Vi       , Re^Vi       , Cea         , 1 Kea       , 5 Kea       , Re^Vi       , Re^Vi       , Cea         , Aa          , Aa          , Aa          , Aa          , Aa          , Aa          , Aa          , Aa          
Aa          , Aa          , Aa          , Aa^Fda      , Aa          , Aa          , Aa          , Rb          , Rb          , Ww^Bw/      , Cea         , Re^Vi       , Cea         , 3 Kea       , 2 Kea       , 4 Kea       , Cea         , Re^Vi       , Cea         , Ai          , Aa          , Aa          , Aa          , Aa          , Aa          , Aa          , Aa          
Aa          , Aa          , Aa          , Aa          , Aa          , Aa          , Rb          , Rb          , Aa          , Ww^Bw\      , Cea         , Cea         , Re^Vi       , Re^Vi       , Re^Vi       , Re^Vi       , Re^Vi       , Cea         , Cea         , Ai          , Gs^Fdw      , Aa          , Aa          , Aa          , Aa          , Aa          , Aa          
Aa          , Aa          , Aa          , Aa          , Rb          , Rb          , Aa          , Aa          , Aa          , Wwr         , Aa          , Cea         , Cea         , Re^Vi       , Re^Vi       , Re^Vi       , Cea         , Ce          , Rb          , Aa          , Aa          , Aa          , Aa          , Aa          , Aa          , Aa          , Aa          
Aa          , Aa          , Aa          , Aa          , Rb          , Aa          , Aa          , Aa          , Aa          , Wwr         , Wwr         , Aa          , Aa          , Cea         , Cea         , Cea         , Aa          , Rb          , Rb          , Rb          , Rb          , Aa          , Aa          , Aa          , Aa          , Aa          , Aa          
Ha          , Aa          , Rb          , Rb          , Aa          , Aa          , Aa          , Aa          , Aa          , Aa          , Aa          , Wwr         , Wwr         , Aa          , Ai          , Aa          , Ai          , Aa          , Aa          , Rb          , Rb          , Aa          , Aa          , Aa          , Aa          , Aa          , Aa          
Ha          , Rb          , Aa          , Aa          , Aa^Fda      , Aa          , Aa          , Aa          , Aa          , Aa^Fda      , Aa          , Aa          , Aa          , Wwr         , Wwr         , Ai          , Aa          , Aa          , Aa          , Rb          , Rb          , Aa          , Aa          , Aa          , Aa          , Aa          , Aa          
Rb          , Rb          , Aa          , Aa^Fda      , Aa          , Aa          , Aa          , Aa          , Aa          , Aa          , Aa          , Aa          , Aa          , Aa          , Aa          , Wwr         , Wwr         , Aa          , Aa          , Rb          , Rb          , Aa          , Aa          , Aa          , Aa          , Aa          , Aa          
Ha          , Ha          , Ha          , Aa          , Aa          , Aa          , Aa          , Aa          , Aa          , Aa          , Aa          , Aa          , Aa^Fda      , Aa          , Aa          , Aa          , Aa^Fda      , Wwr         , Wwr         , Rb          , Rb          , Aa          , Aa          , Aa          , Aa          , Aa          , Aa          
Ha          , Ha          , Ha          , Ha          , Ha          , Aa          , Aa          , Aa          , Aa          , Aa          , Aa          , Aa          , Aa          , Aa          , Aa          , Aa          , Aa          , Aa          , Rb          , Ww^Bw|      , Wwr         , Aa          , Aa          , Aa          , Aa          , Aa          , Aa          
Ha          , Ha          , Ha          , Ha          , Ha          , Ha          , Ha          , Ha          , Ha          , Aa          , Aa          , Aa          , Aa          , Aa          , Aa          , Aa          , Aa          , Aa          , Rb          , Rb          , Rb          , Wwr         , Wwr         , Aa          , Aa          , Aa          , Aa          
Ms          , Ms          , Ms          , Ms          , Ms          , Ms          , Ms          , Ha          , Ha          , Ha          , Ha          , Aa          , Aa          , Aa          , Aa          , Aa          , Aa          , Aa          , Rb          , Rb          , Rb          , Aa          , Aa          , Wwr         , Aa          , Aa          , Aa          
Ms          , Ms          , Ms          , Ms          , Ms          , Ms          , Ms          , Ms          , Ms          , Ha          , Ha          , Ha          , Ha          , Aa          , Aa          , Aa          , Aa          , Aa          , Rb          , Rb          , Rb          , Aa          , Aa          , Wwr         , Wwr         , Aa          , Aa          
Ms          , Ms          , Ms          , Ms          , Ms          , Ms          , Ms          , Ms          , Ms          , Ha          , Ha          , Ha          , Ha          , Aa          , Aa          , Aa          , Aa          , Aa          , Rb          , Rb          , Rb          , Aa          , Aa          , Aa          , Aa          , Wwr         , Wwr         
Ms          , Ms          , Ms          , Ms          , Ms          , Ms          , Ms          , Ms          , Ms          , Ha          , Ha          , Ha          , Ha          , Ha          , Ha          , Aa          , Aa          , Aa          , Rb          , Rb          , Rb          , Aa          , Aa          , Aa          , Wwr         , Wwr         , Wwr         
Ms          , Ms          , Ms          , Ms          , Ms          , Ms          , Ms          , Ms          , Ms          , Ha          , Ha          , Ha          , Ha          , Ha          , Ha          , Ha          , Ha          , Aa          , Rb          , Rb          , Rb          , Aa          , Aa          , Aa          , Wwr         , Wwr         , Wwr         
