border_size=1
usage=map

Gg          , Gg          , Gg          , Gg          , Aa          , Gg          , Gg          , Gg          , Gg          , Gg          , Gg          , Gg          , Gg          , Gg          , Gg          , Gg          , Aa          , Gg          , Aa          , Aa          , Aa          , Gg          , Aa          , Aa          , Aa          , Gg          , Gg          , Gg          , Gg          , Gg          , Gg          , Gg          
Aa          , Aa          , Aa          , Aa          , Aa          , Aa          , Gg          , Gg          , Gg          , Gg          , Gg          , Gg          , Gg          , Gg          , Gg          , Aa          , Aa          , Aa          , Aa          , Aa          , Aa          , Gg          , Aa          , Aa          , Aa          , Gg          , Aa          , Gg          , Gg          , Gg          , Gg          , Gg          
Aa          , Re^Vct      , Aa          , Aa          , Aa          , Aa          , Re^Vct      , Gg          , Gg          , Aa          , Gg          , Gg          , Aa          , Aa          , Aa          , Aa          , Aa          , Aa          , Aa          , Aa          , Aa          , Gg          , Gg          , Aa          , Gg          , Aa          , Aa          , Aa          , Gg          , Gg          , Aa          , Gg          
Gg          , Aa          , Aa          , Aa          , Aa          , Gg          , Gg          , Gg          , Aa          , Aa          , Aa          , Gg          , Aa          , Aa          , Aa          , Gg          , Gg          , Gg          , Gg          , Aa          , Hh          , Hh          , Hh          , Ha          , Ha          , Aa          , Aa          , Aa          , Aa          , Aa          , Aa          , Aa          
Gg          , Gg          , Ce          , Aa          , Ce          , Gg          , Gg          , Aa          , Gg          , Aa          , Aa          , Aa          , Gg          , Aa          , Gg          , Gg          , Hh          , Hh          , Ha          , Ha^Vca      , Ha          , Ha          , Hh          , Hh          , Ha          , Hh          , Ha          , Aa          , Aa          , Aa          , Aa          , Aa          
Gg          , Gg          , Ce          , 1 Ke        , Ce          , Gg          , Aa          , Aa          , Gg          , Aa          , Aa          , Aa          , Gg          , Gg          , Hh          , Ha          , Hh          , Hh          , Hh          , Ha          , Mm          , Mm          , Mm          , Mm          , Mm          , Ha          , Ha^Vca      , Aa          , Aa          , Aa          , Aa          , Gg          
Gg          , Gg          , Gg          , Aa          , Aa          , Aa          , Re^Vct      , Aa          , Gg          , Gg          , Gg          , Gg          , Ha^Fda      , Ha          , Ha          , Ha          , Mm^Vc       , Mm          , Mm          , Mm          , Ms          , Ms          , Ms          , Ms          , Mm          , Ha          , Ha          , Ha          , Hh          , Aa          , Aa          , Aa          
Gg          , Re^Vct      , Gg          , Aa          , Aa          , Aa          , Aa          , Aa          , Gg          , Gg          , Gg          , Ha^Fma      , Ha^Vca      , Ha          , Ha          , Mm          , Ms          , Mm          , Mm          , Mm          , Mm          , Ms          , Ms          , Ms          , Ms          , Mm          , Mm          , Hh          , Ha          , Aa          , Aa          , Aa          
Gg          , Gg          , Gg          , Gg          , Aa          , Gg          , Aa          , Gg          , Gg          , Gg          , Ha^Fda      , Ha^Fda      , Ha          , Ha          , Mm          , Mm          , Ms          , Mm          , Mm          , Mm          , Mm          , Mm          , Ms          , Ms          , Mm          , Mm          , Mm          , Ha          , Hh          , Hh          , Gg          , Gg          
Gg          , Gg          , Gg          , Aa          , Aa          , Aa          , Aa          , Aa          , Gg          , Gg          , Gg          , Ha^Fma      , Hh          , Ha          , Mm          , Ms          , Ms          , Mm          , Mm          , Mm          , Mm          , Mm          , Mm          , Mm          , Mm          , Mm          , Mm          , Mm          , Hh          , Hh          , Gg          , Gg          
Gg          , Gg          , Gg          , Aa          , Aa          , Aa          , Aa          , Aa          , Gg          , Gg          , Gg          , Ha^Fma      , Hh          , Ha          , Mm          , Ms          , Ms          , Mm          , Ai          , Mm          , Mm^Vc       , Mm          , Mm          , Mm          , Mm          , Mm          , Mm          , Mm          , Ha          , Hh          , Ha          , Gg          
Gg          , Gg          , Aa          , Aa          , Aa          , Gg          , Gg          , Gg          , Gg          , Gg          , Gg          , Ha^Fpa      , Ha          , Hh          , Mm          , Ms          , Ai          , Ai          , Mm          , Ai          , Ai          , 2 Ms        , Ai          , Ai          , Ai          , Mm          , Mm          , Mm          , Mm          , Hh          , Hh          , Gg          
Gg          , Gg          , Aa          , Aa          , Aa          , Gg          , Aa          , Aa          , Aa          , Gg          , Gg          , Gg          , Ww          , Ww          , Ww          , Ww          , Mm          , Mm          , Mm          , Mm          , Mm          , Ai          , Ai          , Ai          , Mm          , Mm          , Mm          , Mm          , Mm          , Hh          , Hh          , Gg          
Gg          , Gg          , Gg          , Aa          , Aa          , Gg          , Aa          , Aa          , Aa          , Gg          , Gg          , Gg          , Ww          , Ww          , Ww          , Mm          , Mm          , Mm          , Mm          , Mm          , Mm          , Mm          , Ai          , Ai          , Mm          , Mm          , Mm          , Mm          , Mm          , Ha          , Ha          , Gg          
Gg          , Gg          , Gg          , Aa          , Aa          , Aa          , Gg          , Aa          , Gg          , Gg          , Gg          , Gg          , Ww          , Ww          , Mm          , Mm^Vc       , Ms          , Mm          , Mm          , Mm          , Mm          , Ms          , Ms          , Mm          , Mm          , Mm          , Mm          , Mm          , Mm          , Ha          , Hh          , Gg          
Gg          , Gg          , Gg          , Aa          , Aa          , Aa          , Gg          , Gg          , Gg          , Gg          , Ww          , Ww          , Ww          , Ww          , Mm          , Mm          , Mm          , Mm          , Mm^Vc       , Mm          , Mm          , Mm          , Mm          , Ms          , Mm          , Mm          , Mm          , Mm          , Mm          , Hh          , Hh          , Gg          
Gg          , Gg          , Aa          , Aa          , Aa          , Gg          , Gg          , Gg          , Ww          , Ww          , Ww          , Ww          , Hh          , Ha^Vca      , Ha          , Mm          , Mm          , Mm          , Mm          , Mm          , Mm          , Mm          , Mm          , Mm          , Mm          , Mm          , Mm          , Mm          , Hh          , Hh          , Hh          , Gg          
Gg          , Gg          , Aa          , Aa          , Aa          , Gg          , Gg          , Gg          , Ww          , Ww          , Hh^Fds      , Hh^Fds      , Hh^Fds      , Ha          , Hh          , Hh          , Mm          , Mm          , Mm          , Mm          , Mm          , Mm          , Mm          , Mm          , Mm          , Mm          , Hh          , Hh          , Ha          , Ha          , Gg          , Gg          
Gg          , Aa          , Aa          , Aa          , Aa          , Aa          , Aa          , Gg          , Ww          , Ww          , Hh^Fds      , Hh^Fds      , Chs         , Hh          , Hh          , Hh          , Mm          , Mm          , Ha          , Mm          , Mm          , Mm          , Mm          , Mm          , Hh          , Ha^Vca      , Ha          , Ha          , Gg          , Gg          , Gg          , Gg          
Aa          , Aa          , Aa          , Aa          , Aa          , Aa          , Aa          , Gg          , Ww          , Ww          , Chw         , Chs         , Chs         , Hh          , Ha          , Mm          , Hh          , Mm          , Hh          , Mm          , Mm          , Mm          , Hh          , Hh          , Ha          , Hh          , Gg          , Gg          , Gg          , Gg          , Gg          , Gg          
Aa          , Aa          , Aa          , Gg          , Gg          , Aa          , Gg          , Gg          , Ww          , Ww          , Chw         , Chs         , 3 Khs       , Hh          , Ha          , Hh          , Ha          , Ha^Vca      , Ha          , Ha          , Ha          , Hh          , Ha          , Ha          , Hh          , Ha          , Gg          , Gg          , Gg          , Gg          , Hh^Fds      , Hh^Fds      
Gg          , Aa          , Gg          , Gg          , Gg          , Gg          , Gg          , Gg          , Gg          , Ww          , Ww          , Ss          , Ss          , Ss          , Ss          , Ha          , Gg          , Ha          , Gg          , Hh          , Hh          , Ha          , Gg          , Hh^Fds      , Hh^Fds      , Hh^Fds      , Hh^Fds      , Hh^Fds      , Hh^Fds      , Hh^Fds      , Hh^Fds      , Hh^Fds      
