border_size=1
usage=map

Dd          , Dd          , Dd          , Dd          , Dd          , Dd          , Dd          , Dd          , Dd          , Dd          , Dd          , Dd          , Dd          , Dd          , Ql          , Dd          , Dd          , Dd          , Dd          , Dd          , Dd          , Dd          , Dd          , Dd          , Dd          , Dd          , Dd          , Dd          , Dd          , Dd          , Dd          , Dd          , Dd          , Dd          
Dd          , Dd          , Dd          , Dd          , Dd          , Dd          , Dd          , Dd          , Dd          , Dd          , Dd          , Dd          , Dd          , Dd          , Ql          , Dd          , Dd          , Dd          , Dd          , Dd          , Dd          , Dd          , Dd          , Dd          , Dd          , Dd          , Dd          , Dd          , Dd          , Dd          , Dd          , Dd          , Dd          , Dd          
Dd          , Dd          , Dd          , Dd          , Dd          , Dd          , Dd          , Dd          , Dd          , Dd          , Dd          , Dd          , Dd          , Dd          , Dd          , Ql          , Dd          , Dd          , Dd          , Dd          , Dd          , Dd          , Dd          , Dd          , Dd          , Dd          , Cud         , Cud         , Cud         , Dd          , Dd          , Dd          , Dd          , Dd          
Gd          , Dd          , Dd          , Dd          , Dd          , Dd          , Dd          , Dd          , Dd          , Dd          , Dd          , Dd          , Dd          , Dd          , Dd          , Ql          , Ql          , Dd          , Dd          , Dd          , Dd          , Dd          , Dd          , Dd          , Dd          , Dd          , Cud         , 4 Kud       , Cud         , Cud         , Dd          , Dd          , Dd          , Dd          
Gd          , Dd          , Gd          , Gd          , Gd          , Dd          , Dd          , Dd          , Dd          , Dd          , Dd          , Dd          , Dd          , Dd          , Dd          , Dd          , Ql          , Dd          , Dd          , Dd          , Dd          , Dd          , Dd          , Dd          , Dd          , Dd          , Dd          , Cud         , Cud         , Cud         , Dd          , Dd          , Dd          , Dd          
Gd          , Gd          , Gd          , Gd          , Gd          , Gd          , Gd          , Dd          , Dd          , Dd          , Dd          , Dd          , Dd          , Dd          , Dd          , Dd          , Dd          , Ql          , Dd          , Dd          , Dd          , Dd          , Dd          , Dd          , Dd          , Dd          , Dd          , Dd          , Dd          , Dd          , Dd          , Dd          , Dd          , Dd          
Gs          , Gd          , Gs          , Gs          , Gd          , Gd          , Gd          , Gd          , Gd          , Dd          , Dd          , Dd          , Dd          , Dd          , Dd          , Dd          , Dd          , Ql          , Qxu^Bs/     , Dd          , Dd          , Dd          , Dd          , Dd          , Dd          , Dd          , Dd          , Dd          , Dd          , Dd          , Dd          , Dd          , Xu          , Dd          
Gs          , Gs          , Gs          , Gs          , Gs          , Gd          , Gd          , Gd          , Gd          , Dd          , Dd          , Dd          , Dd          , Dd          , Dd          , Dd          , Dd          , Dd          , Ql          , Ql          , Dd          , Dd          , Dd          , Dd          , Dd          , Dd          , Dd          , Dd          , Dd          , Dd          , Xu          , Xu          , Xu          , Xu          
Gs          , Gs          , Gs          , Gs          , Gs          , Gs          , Gs          , Gd          , Gd          , Gd          , Gd          , Dd          , Dd          , Dd          , Dd          , Dd          , Dd          , Dd          , Dd          , Ql          , Ql          , Dd          , Dd          , Dd          , Dd          , Dd          , Dd          , Dd          , Dd          , Dd          , Urb^Ii      , Urb^Ii      , Urb^Ii      , Urb^Ii      
Gll^Fmf     , Gs          , Gg          , Gg          , Gg          , Gs          , Gs          , Gs          , Gd          , Gd          , Gd          , Dd          , Gd          , Dd          , Dd          , Dd          , Dd          , Dd          , Dd          , Dd          , Dd          , Ql          , Qxu^Bs/     , Dd          , Qxu^Bs|     , Dd          , Dd          , Dd          , Dd          , Dd          , Xu          , Urb^Ii      , Urb^Ii      , Urb^Ii      
Gll^Fmf     , Gll^Fmf     , Gg          , Gg          , Gg          , Gg          , Gs          , Gs          , Gs          , Gd          , Gd          , Gd          , Gd          , Gd          , Gd          , Dd          , Dd          , Dd          , Dd          , Dd          , Dd          , Dd          , Dd          , Ql          , Dd          , Ql          , Qxu^Bs|     , Dd          , Dd          , Dd          , Dd          , Xu          , Xu          , Xu          
Gll^Fmf     , Gll^Fmf     , Gg          , Gg          , Gg          , Gg          , Gg          , Gs          , Gs          , Gs          , Gs          , Gd          , Gs          , Gd          , Gd          , Gd          , Dd          , Dd          , Dd          , Dd          , Dd          , Dd          , Dd          , Dd          , Dd          , Dd          , Dd          , Ql          , Qxu^Bs/     , Dd          , Dd          , Dd          , Dd          , Dd          
Gll^Fmf     , Gll^Fmf     , Gg          , Gg          , Ce          , Gg          , Gg          , Gg          , Gg          , Gs          , Gs          , Gs          , Gs          , Gs          , Gs          , Gd          , Gd          , Dd          , Dd          , Dd          , Dd          , Dd          , Dd          , Dd          , Dd          , Dd          , Cud         , Dd          , Dd          , Ql          , Ql          , Dd          , Dd          , Dd          
Gll^Fmf     , Gll^Fmf     , Ce          , Ce          , 2 Ke        , Ce          , Ce          , Gg          , Gg          , Gg          , Gg          , Gs          , Gs          , Gs          , Gs          , Gd          , Gd          , Gd          , Gd          , Dd          , Dd          , Dd          , Dd          , Dd          , Dd          , Cud         , 3 Kud       , Cud         , Cud         , Dd          , Dd          , Ql          , Ql          , Dd          
Gll^Fmf     , Gll^Fmf     , 1 Gg        , Ce          , Ce          , Ce          , Gg          , Gg          , Gg          , Gg          , Gll^Fmf     , Gg          , Gg          , Gs          , Gs          , Gs          , Gs          , Gd          , Gd          , Gd          , Gd          , Dd          , Dd          , Dd          , Dd          , Cud         , Cud         , Cud         , Cud         , Dd          , Dd          , Dd          , Dd          , Ql          
Gg          , Gg          , Gg          , Gg          , Gll^Fmf     , Gg          , Gll^Fmf     , Gg          , Gll^Fmf     , Gll^Fmf     , Gll^Fmf     , Gll^Fmf     , Gll^Fmf     , Gg          , Gg          , Gs          , Gs          , Gs          , Gs          , Gd          , Gd          , Dd          , Dd          , Dd          , Dd          , Dd          , Dd          , Cud         , Dd          , Dd          , Dd          , Dd          , Dd          , Dd          
Gg          , Gg          , Gll^Fmf     , Gll^Fmf     , Gll^Fmf     , Gll^Fmf     , Gll^Fmf     , Gll^Fmf     , Gll^Fmf     , Gll^Fmf     , Gll^Fmf     , Gll^Fmf     , Gll^Fmf     , Gll^Fmf     , Gg          , Gs          , Gs          , Gs          , Gs          , Gd          , Gd          , Gd          , Gd          , Dd          , Dd          , Dd          , Dd          , Dd          , Dd          , Dd          , Dd          , Dd          , Dd          , Dd          
