border_size=1
usage=map

Ur^Ii       , Ur^Ii       , Ur^Ii       , Ur^Ii       , Ur^Ii       , Xu          , Xu          , Xu          , Xu          , Xu          , Xu          , Xu          , Xu          , Xu          , Xu          , Xu          , Xu          , Xu          , Xu          , Xu          , Xu          , Xu          , Xu          , Xu          , Xu          , Xu          , Xu          , Xu          , Xu          , Xu          , Xu          , Xu          , Xu          , Xu          , Xu          , Xu          , Xu          , Xu          , Xu          , Xu          
Ur^Ii       , Ur^Ii       , Ur^Ii       , Ur^Ii       , Urb         , Cud         , Urb         , Urb         , Urb         , Xu          , Xu          , Xu          , Xu          , Xu          , Xu          , Xu          , Xu          , Xu          , Xu          , Xu          , Xu          , Xu          , Xu          , Xu          , Xu          , Xu          , Xu          , Xu          , Xu          , Xu          , Xu          , Xu          , Xu          , Xu          , Xu          , Xu          , Xu          , Xu          , Xu          , Xu          
Xu          , Ur^Ii       , Urb         , Urb         , Urb         , Urb         , Cud         , Urb         , Xu          , Xu          , Xu          , Xu          , Xu          , Xu          , Xu          , Xu          , Xu          , Xu          , Xu          , Xu          , Xu          , Xu          , Xu          , Xu          , Xu          , Xu          , Xu          , Xu          , Xu          , Xu          , Xu          , Xu          , Xu          , Xu          , Xu          , Xu          , Xu          , Xu          , Xu          , Xu          
Xu          , Cud         , Urb         , Urb         , Urb         , Urb         , 1 Kud       , Cud         , Cud         , Xu          , Urb         , Urb         , Urb         , Xu          , Xu          , Xu          , Xu          , Xu          , Xu          , Xu          , Xu          , Xu          , Xu          , Xu          , Xu          , Xu          , Xu          , Xu          , Xu          , Xu          , Xu          , Xu          , Xu          , Xu          , Xu          , Xu          , Xu          , Xu          , Xu          , Xu          
Xu          , Xu          , Urb         , Urb         , Xu          , Cud         , Cud         , Cud         , Urb         , Urb         , Urb         , Urb         , Uu          , Urb         , Urb         , Xu          , Xu          , Xu          , Xu          , Xu          , Xu          , Xu          , Xu          , Xu          , Xu          , Xu          , Xu          , Xu          , Xu          , Xu          , Xu          , Xu          , Xu          , Xu          , Xu          , Xu          , Xu          , Xu          , Xu          , Xu          
Xu          , Xu          , Xu          , Xu          , Xu          , Xu          , Xu          , Urb         , Uu          , Urb         , Uu          , Uu          , Urb         , Urb         , Urb         , Urb         , Urb         , Xu          , Xu          , Xu          , Xu          , Xu          , Xu          , Xu          , Xu          , Xu          , Xu          , Xu          , Xu          , Xu          , Xu          , Xu          , Xu          , Xu          , Xu          , Xu          , Xu          , Xu          , Xu          , Xu          
Xu          , Xu          , Xu          , Xu          , Xu          , Xu          , Xu          , Uu          , Uu          , Urb         , Urb         , Urb         , Urb         , Uu          , Uu          , Uu          , Urb         , Urb         , Rr          , Xu          , Xu          , Xu          , Xu          , Xu          , Xu          , Xu          , Xu          , Xu          , Xu          , Xu          , Xu          , Xu          , Xu          , Xu          , Xu          , Xu          , Xu          , Xu          , Xu          , Xu          
Xu          , Xu          , Xu          , Xu          , Xu          , Xu          , Xu          , Urb         , Urb         , Urb         , Uu          , Urb         , Uu          , Uu          , Urb         , Uu          , Rr          , Rr          , Rr          , Rr          , Rr          , Xu          , Xu          , Xu          , Xu          , Xu          , Xu          , Xu          , Xu          , Xu          , Xu          , Xu          , Xu          , Xu          , Xu          , Xu          , Xu          , Xu          , Xu          , Xu          
Xu          , Xu          , Xu          , Xu          , Xu          , Xu          , Xu          , Urb         , Urb         , Urb         , Uu          , Uu          , Urb         , Urb         , Rr          , Rr          , Rr          , Rr          , Rr          , Rr          , Rr          , Rr          , Rr          , Xu          , Xu          , Xu          , Xu          , Xu          , Xu          , Xu          , Xu          , Xu          , Xu          , Xu          , Xu          , Xu          , Xu          , Xu          , Xu          , Xu          
Xu          , Xu          , Xu          , Xu          , Xu          , Xu          , Xu          , Urb         , Uu          , Uu          , Uu          , Urb         , Urb         , Rr          , Rr          , Rr          , Rr          , Rr          , Qxu         , Rr          , Rr          , Rr          , Rr          , Rr          , Xu          , Xu          , Xu          , Xu          , Xu          , Xu          , Xu          , Xu          , Xu          , Xu          , Xu          , Xu          , Xu          , Xu          , Xu          , Xu          
Xu          , Xu          , Xu          , Xu          , Xu          , Xu          , Xu          , Urb         , Uu          , Uu          , Urb         , Uu          , Urb         , Rr          , Rr          , Rr          , Qxu         , Qxu         , Ql          , Qxu         , Qxu         , Rr          , Rr          , Rr          , Xu          , Xu          , Xu          , Xu          , Xu          , Xu          , Xu          , Xu          , Xu          , Xu          , Xu          , Xu          , Xu          , Xu          , Xu          , Xu          
Xu          , Xu          , Xu          , Xu          , Xu          , Xu          , Xu          , Xu          , Xu          , Uu          , Urb         , Urb         , Urb         , Rr          , Rr          , Rr          , Qxu         , Ql          , Ql          , Ql          , Qxu         , Rr          , Rr          , Rr          , Xu          , Xu          , Xu          , Xu          , Xu          , Xu          , Xu          , Xu          , Xu          , Xu          , Xu          , Xu          , Xu          , Xu          , Xu          , Xu          
Xu          , Xu          , Xu          , Xu          , Xu          , Xu          , Xu          , Xu          , Xu          , Xu          , Xu          , Urb         , Urb         , Rr          , Rr          , Rr          , Rr          , Qxu         , Qxu         , Qxu         , Rr          , Rr          , Rr          , Rr          , Xu          , Xu          , Xu          , Xu          , Xu          , Xu          , Xu          , Xu          , Xu          , Xu          , Xu          , Xu          , Xu          , Xu          , Xu          , Xu          
Xu          , Xu          , Xu          , Xu          , Xu          , Xu          , Xu          , Xu          , Xu          , Xu          , Xu          , Xu          , Xu          , Rr          , Rr          , Rr          , Rr          , Rr          , Rr          , Rr          , Rr          , Rr          , Rr          , Rr          , Ql          , Xu          , Xu          , Xu          , Xu          , Xu          , Xu          , Xu          , Xu          , Xu          , Xu          , Xu          , Xu          , Xu          , Xu          , Xu          
Xu          , Xu          , Xu          , Xu          , Xu          , Xu          , Xu          , Xu          , Xu          , Xu          , Xu          , Xu          , Xu          , Xu          , Xu          , Rr          , Rr          , Rr          , Rr          , Rr          , Rr          , Rr          , Ql          , Ql^Bs\      , Uu          , Ql          , Ql          , Xu          , Xu          , Xu          , Cud         , Xu          , Cud         , Xu          , Cud         , Xu          , Xu          , Xu          , Xu          , Xu          
Xu          , Xu          , Xu          , Xu          , Xu          , Xu          , Xu          , Xu          , Xu          , Xu          , Xu          , Xu          , Xu          , Xu          , Xu          , Xu          , Xu          , Rr          , Rr          , Rr          , Xu          , Ql          , Ql          , Ql          , Ql          , Ql^Bs\      , Uu          , Ql          , Ql          , Xu          , Cud         , Cud         , Urb         , Urb         , Urb         , Cud         , Cud         , Xu          , Xu          , Xu          
Xu          , Xu          , Xu          , Xu          , Xu          , Xu          , Xu          , Xu          , Xu          , Xu          , Xu          , Xu          , Xu          , Xu          , Xu          , Xu          , Xu          , Xu          , Xu          , Xu          , Xu          , Xu          , Xu          , Ql          , Ql          , Ql          , Ql          , Ql^Bs\      , Uu          , Cud         , Urb         , Urb         , Cud         , Cud         , Cud         , Urb         , Urb         , Cud         , Cud         , Xu          
Xu          , Xu          , Xu          , Xu          , Xu          , Xu          , Xu          , Xu          , Xu          , Xu          , Xu          , Xu          , Xu          , Xu          , Xu          , Xu          , Xu          , Xu          , Xu          , Xu          , Xu          , Xu          , Xu          , Xu          , Xu          , Ql          , Ql          , Ql          , Cud         , Cud         , Urb         , Cud         , Cud         , 2 Kud       , Cud         , Cud         , Urb         , Urb         , Cud         , Xu          
Xu          , Xu          , Xu          , Xu          , Xu          , Xu          , Xu          , Xu          , Xu          , Xu          , Xu          , Xu          , Xu          , Xu          , Xu          , Xu          , Xu          , Xu          , Xu          , Xu          , Xu          , Xu          , Xu          , Xu          , Xu          , Xu          , Xu          , Ql          , Xu          , Cud         , Urb         , Urb         , Urb         , Urb         , Urb         , Urb         , Cud         , Cud         , Xu          , Xu          
Xu          , Xu          , Xu          , Xu          , Xu          , Xu          , Xu          , Xu          , Xu          , Xu          , Xu          , Xu          , Xu          , Xu          , Xu          , Xu          , Xu          , Xu          , Xu          , Xu          , Xu          , Xu          , Xu          , Xu          , Xu          , Xu          , Xu          , Xu          , Xu          , Cud         , Cud         , Cud         , Xu          , Cud         , Cud         , Xu          , Xu          , Xu          , Xu          , Xu          
Xu          , Xu          , Xu          , Xu          , Xu          , Xu          , Xu          , Xu          , Xu          , Xu          , Xu          , Xu          , Xu          , Xu          , Xu          , Xu          , Xu          , Xu          , Xu          , Xu          , Xu          , Xu          , Xu          , Xu          , Xu          , Xu          , Xu          , Xu          , Xu          , Xu          , Urb         , Xu          , Xu          , Xu          , Urb         , Xu          , Xu          , Xu          , Xu          , Xu          
Xu          , Xu          , Xu          , Xu          , Xu          , Xu          , Xu          , Xu          , Xu          , Xu          , Xu          , Xu          , Xu          , Xu          , Uu^Br/      , Xu          , Xu          , Xu          , Xu          , Xu          , Xu          , Xu          , Xu          , Xu          , Xu          , Xu          , Xu          , Xu          , Xu          , Xu          , Urb         , Urb         , Xu          , Urb         , Urb         , Xu          , Xu          , Urb         , Urb         , Urb         
Xu          , Xu          , Xu          , Xu          , Xu          , Xu          , Xu          , Xu          , Xu          , Xu          , Xu          , Xu          , Uu^Br/      , Uu^Br/      , Xu          , Uu^Br\      , Uu^Br\      , Xu          , Xu          , Xu          , Xu          , Xu          , Xu          , Xu          , Xu          , Xu          , Ur          , Xu          , Ur          , Urb         , Urb         , Xu          , Xu          , Xu          , Xu          , Urb         , Urb         , Xu          , Xu          , Urb         
Xu          , Xu          , Xu          , Xu          , Xu          , Xu          , Xu          , Xu          , Xu          , Xu          , Uu^Br|      , Uu^Br/      , Xu          , Xu          , Xu          , Xu          , Xu          , Uu^Br|      , Xu          , Xu          , Xu          , Xu          , Xu          , Xu          , Ur          , Ur          , Ur          , Ur          , Urb         , Urb         , Ur          , Xu          , Uu          , Xu          , Xu          , Xu          , Xu          , Urb         , Urb         , Xu          
Xu          , Xu          , Xu          , Xu          , Xu          , Xu          , Xu          , Xu          , Xu          , Xu          , Uu^Br|      , Xu          , Xu          , Xu          , Xu          , Xu          , Xu          , Uu^Br|      , Xu          , Xu          , Xu          , Xu          , Xu          , Xu          , Ur          , Ur          , Ur          , Urb         , Urb         , Urb         , Urb         , Ur          , Ur          , Xu          , Xu          , Xu          , Xu          , Xu          , Xu          , Urb         
Gg^Ii       , Gg^Ii       , Gg^Ii       , Xu          , Xu          , Xu          , Xu          , Xu          , Xu          , Xu          , Uu^Br|      , Xu          , Xu          , Xu          , Xu          , Xu          , Xu          , Uu^Br|      , Uu^Br\      , Xu          , Xu          , Xu          , Xu          , Xu          , Ur          , Ur          , Urb         , Urb         , Uu^Br\      , Urb         , Urb         , Urb         , Ur          , Xu          , Xu          , Xu          , Xu          , Xu          , Xu          , Xu          
Gg^Ii       , Gg^Ii       , Gg^Ii       , Gg^Ii       , Gg^Ii       , Xu          , Xu          , Xu          , Xu          , Xu          , Uu^Br|      , Xu          , Xu          , Xu          , Xu          , Xu          , Xu          , Xu          , Xu          , Uu^Br\      , Uu^Br\      , Xu          , Xu          , Xu          , Xu          , Ur          , Ur          , Ur          , Xu          , Uu^Br\      , Uu^Br\      , Ur          , Xu          , Xu          , Xu          , Xu          , Xu          , Xu          , Xu          , Xu          
Gg^Ii       , Gg^Ii       , Gg^Ii       , Gg^Ii       , Gg^Ii       , Gg^Ii       , Xu          , Xu          , Xu          , Xu          , Uu^Br|      , Xu          , Xu          , Xu          , Xu          , Xu          , Xu          , Xu          , Xu          , Xu          , Xu          , Uu^Br\      , Uu^Br\      , Xu          , Xu          , Xu          , Xu          , Xu          , Xu          , Xu          , Xu          , Uu^Br\      , Uu^Br\      , Xu          , Xu          , Xu          , Xu          , Xu          , Xu          , Xu          
Gg^Ii       , Gg^Ii       , Gg^Ii       , Gg^Ii       , Gg^Br/      , Gg^Br\      , Gg^Br\      , Xu          , Xu          , Xu          , Uu^Br|      , Xu          , Xu          , Xu          , Xu          , Xu          , Xu          , Xu          , Xu          , Xu          , Xu          , Xu          , Xu          , Uu^Br\      , Uu^Br/      , Uu^Br\      , Uu^Br/      , Uu^Br\      , Uu^Br\      , Xu          , Xu          , Xu          , Uu^Br|      , Xu          , Xu          , Xu          , Xu          , Xu          , Xu          , Xu          
Gg^Ii       , Gg^Ii       , Gg^Br/      , Gg^Br/      , Gg^Ii       , Gg^Ii       , Gg^Ii       , Gg^Br\      , Gg^Br\      , Xu          , Uu^Br|      , Xu          , Xu          , Xu          , Xu          , Xu          , Xu          , Xu          , Xu          , Xu          , Xu          , Xu          , Xu          , Xu          , Xu          , Xu          , Xu          , Xu          , Xu          , Uu^Br\      , Uu^Br\      , Xu          , Uu^Br/      , Xu          , Xu          , Xu          , Xu          , Xu          , Xu          , Xu          
Gg^Br/      , Gg^Br/      , Gg^Ii       , Gg^Ii       , Gg^Ii       , Gg^Ii       , Gg^Ii       , Gg^Ii       , Gg^Ii       , Gg^Br/      , Xu          , Xu          , Xu          , Xu          , Xu          , Xu          , Xu          , Xu          , Xu          , Xu          , Xu          , Xu          , Xu          , Xu          , Xu          , Xu          , Xu          , Xu          , Xu          , Xu          , Xu          , Uu^Br\      , Xu          , Xu          , Xu          , Xu          , Xu          , Xu          , Xu          , Xu          
Gg^Ii       , Gg^Ii       , Gg^Ii       , Gg^Ii       , Gg^Ii       , Gg^Ii       , Gg^Ii       , Gg^Ii       , Gg^Ii       , Gg^Ii       , Gg^Ii       , Xu          , Xu          , Xu          , Xu          , Xu          , Xu          , Xu          , Xu          , Xu          , Xu          , Xu          , Xu          , Xu          , Xu          , Xu          , Xu          , Xu          , Xu          , Xu          , Xu          , Xu          , Xu          , Xu          , Xu          , Xu          , Xu          , Xu          , Xu          , Xu          
